R 800 600
NO ./textures/wall_no.xpm
SO ./textures/wall_so.xpm
WE ./textures/wall_we.xpm
EA ./textures/wall_ea.xpm
S  ./textures/sprite.xpm
F  0,0,255
C  106,242,192


           1111111111111111111111111
       11111000000000110000000000001
       11111111111111111111111111111
       11111111111111111111111111111
111111111101100000111000000200000111
100100000100000000000000111111111
111111111011000001110000000000001
100000000011000001110111112111111
11110111111111011100000010001
11110111111111011101010010001
11000000110101011000000010001
10002000000000001100000010N01
10000000000000000001010000001
110000011101010111110111100011
11110111 1110101 1000001100001
11111111 1111111 111111111111
