    R 600 800
NO ./wall_no.xpm
SO ./wall_so.xpm
WE ./wall_we.xpm
EA ./wall_ea.xpm
S  ./sprite.xpm
F  0,0,255
C  216,194,250

   11111111111111111
   10000000000000021
1111110111111111111
10200000200000201
10000010000010001
10002010200010001
10000010000010001
10202010002010201
10000010000010001
10002010200210001
10000010000010001
10000000200012N01
11111111111111111
