R 600 800
NO ./wall_no.xpm
SO ./wall_so.xpm
WE ./wall_we.xpm
EA ./wall_ea.xpm
S  ./sprite.xpm
F  0,0,255
C  210,250,194

   11111111111111111
   10000000000000021
1111110111111111111
10200000200000201
10000010000010001
10002010210010001
10000010000010001
10202010002010201
10000010N0001000111111111111
100020102002100000000000001111111111111111111
111111111111111111111111111111111111111111111
